1111111111
222222222
33333333
4444444
555555
66666
7777
888
99
0