NO ./IMAGES/ParticleBoard_TXR1734430725.xpm
SO ./IMAGES/Spiral_Texture.xpm
EA ./IMAGES/StoneWall_TXR1734430725.xpm
WE ./IMAGES/Woodwall3_Texture.xpm


F 222,223,224
C 221,222,223



11111111
1W000001
11111111
