11111111111
12222222221
133333333 1
14444444  1
1555555   1
166666    1
17777     1
1888      1
199       1
10        1
11111111111
